"filename", "language", "SCSS", "CSS", "JavaScript", "HTML", "XML", "comment", "blank", "total"
"/var/www/html/admin-tdo-V3-ReactRedux/src/Containers/AddModal/AddModal.js", "JavaScript", 0, 0, 29, 0, 0, 0, 6, 35
"/var/www/html/admin-tdo-V3-ReactRedux/src/Containers/App/App.js", "JavaScript", 0, 0, 6, 0, 0, 0, 4, 10
"/var/www/html/admin-tdo-V3-ReactRedux/src/Containers/DeleteModal/DeleteModal.js", "JavaScript", 0, 0, 17, 0, 0, 0, 6, 23
"/var/www/html/admin-tdo-V3-ReactRedux/src/Containers/EditModal/EditModal.js", "JavaScript", 0, 0, 31, 0, 0, 0, 6, 37
"/var/www/html/admin-tdo-V3-ReactRedux/src/Containers/FoodList/Antipasti.js", "JavaScript", 0, 0, 17, 0, 0, 0, 6, 23
"/var/www/html/admin-tdo-V3-ReactRedux/src/Containers/FoodList/Boissons.js", "JavaScript", 0, 0, 17, 0, 0, 0, 6, 23
"/var/www/html/admin-tdo-V3-ReactRedux/src/Containers/FoodList/Cichetteria.js", "JavaScript", 0, 0, 17, 0, 0, 0, 6, 23
"/var/www/html/admin-tdo-V3-ReactRedux/src/Containers/FoodList/Cocktails.js", "JavaScript", 0, 0, 17, 0, 0, 0, 6, 23
"/var/www/html/admin-tdo-V3-ReactRedux/src/Containers/FoodList/Desserts.js", "JavaScript", 0, 0, 17, 0, 0, 0, 6, 23
"/var/www/html/admin-tdo-V3-ReactRedux/src/Containers/FoodList/FoodItemContainer.js", "JavaScript", 0, 0, 32, 0, 0, 0, 6, 38
"/var/www/html/admin-tdo-V3-ReactRedux/src/Containers/FoodList/LaCarne.js", "JavaScript", 0, 0, 17, 0, 0, 0, 6, 23
"/var/www/html/admin-tdo-V3-ReactRedux/src/Containers/FoodList/Pasta.js", "JavaScript", 0, 0, 17, 0, 0, 0, 6, 23
"/var/www/html/admin-tdo-V3-ReactRedux/src/Containers/FoodList/Pizze.js", "JavaScript", 0, 0, 17, 0, 0, 0, 6, 23
"/var/www/html/admin-tdo-V3-ReactRedux/src/Containers/FoodList/Tagliate.js", "JavaScript", 0, 0, 17, 0, 0, 0, 6, 23
"/var/www/html/admin-tdo-V3-ReactRedux/src/Containers/FoodList/Vins.js", "JavaScript", 0, 0, 17, 0, 0, 0, 6, 23
"/var/www/html/admin-tdo-V3-ReactRedux/src/Containers/Login/Login.js", "JavaScript", 0, 0, 14, 0, 0, 0, 6, 20
"/var/www/html/admin-tdo-V3-ReactRedux/src/Containers/PostTypeSelector/PostTypeSelector.js", "JavaScript", 0, 0, 9, 0, 0, 0, 5, 14
"/var/www/html/admin-tdo-V3-ReactRedux/src/Middleware/addDishToRestApiMiddleware.js", "JavaScript", 0, 0, 40, 0, 0, 1, 4, 45
"/var/www/html/admin-tdo-V3-ReactRedux/src/Middleware/authMiddleware.js", "JavaScript", 0, 0, 37, 0, 0, 0, 4, 41
"/var/www/html/admin-tdo-V3-ReactRedux/src/Middleware/deleteDishToRestApiMiddleware.js", "JavaScript", 0, 0, 38, 0, 0, 1, 4, 43
"/var/www/html/admin-tdo-V3-ReactRedux/src/Middleware/editDishToRestApiMiddleware.js", "JavaScript", 0, 0, 68, 0, 0, 2, 4, 74
"/var/www/html/admin-tdo-V3-ReactRedux/src/Middleware/loadDishesMiddleware.js", "JavaScript", 0, 0, 39, 0, 0, 1, 4, 44
"/var/www/html/admin-tdo-V3-ReactRedux/src/Middleware/postingErrorHandlerMiddleware.js", "JavaScript", 0, 0, 23, 0, 0, 0, 3, 26
"/var/www/html/admin-tdo-V3-ReactRedux/src/actions/Tdo.js", "JavaScript", 0, 0, 112, 0, 0, 24, 35, 171
"/var/www/html/admin-tdo-V3-ReactRedux/src/assets/index.html", "HTML", 0, 0, 0, 12, 0, 0, 1, 13
"/var/www/html/admin-tdo-V3-ReactRedux/src/components/AddModal/AddModal.js", "JavaScript", 0, 0, 298, 0, 0, 1, 4, 303
"/var/www/html/admin-tdo-V3-ReactRedux/src/components/App/index.js", "JavaScript", 0, 0, 42, 0, 0, 5, 5, 52
"/var/www/html/admin-tdo-V3-ReactRedux/src/components/App/react-logo.svg", "XML", 0, 0, 0, 0, 7, 0, 1, 8
"/var/www/html/admin-tdo-V3-ReactRedux/src/components/App/styles.css", "CSS", 0, 8, 0, 0, 0, 0, 2, 10
"/var/www/html/admin-tdo-V3-ReactRedux/src/components/DeleteModal/DeleteModal.js", "JavaScript", 0, 0, 42, 0, 0, 0, 4, 46
"/var/www/html/admin-tdo-V3-ReactRedux/src/components/EditModal/EditModal.js", "JavaScript", 0, 0, 302, 0, 0, 3, 4, 309
"/var/www/html/admin-tdo-V3-ReactRedux/src/components/Footer/Footer.js", "JavaScript", 0, 0, 23, 0, 0, 0, 4, 27
"/var/www/html/admin-tdo-V3-ReactRedux/src/components/Footer/footer.scss", "SCSS", 12, 0, 0, 0, 0, 0, 1, 13
"/var/www/html/admin-tdo-V3-ReactRedux/src/components/Login/Login.js", "JavaScript", 0, 0, 73, 0, 0, 0, 3, 76
"/var/www/html/admin-tdo-V3-ReactRedux/src/components/Main/DisheComponent/DisheComponent.js", "JavaScript", 0, 0, 0, 0, 0, 0, 1, 1
"/var/www/html/admin-tdo-V3-ReactRedux/src/components/Main/FoodList/Antipasti.js", "JavaScript", 0, 0, 86, 0, 0, 0, 4, 90
"/var/www/html/admin-tdo-V3-ReactRedux/src/components/Main/FoodList/Boissons.js", "JavaScript", 0, 0, 115, 0, 0, 0, 4, 119
"/var/www/html/admin-tdo-V3-ReactRedux/src/components/Main/FoodList/Cichetteria.js", "JavaScript", 0, 0, 101, 0, 0, 0, 4, 105
"/var/www/html/admin-tdo-V3-ReactRedux/src/components/Main/FoodList/Cocktails.js", "JavaScript", 0, 0, 91, 0, 0, 0, 4, 95
"/var/www/html/admin-tdo-V3-ReactRedux/src/components/Main/FoodList/Desserts.js", "JavaScript", 0, 0, 86, 0, 0, 0, 4, 90
"/var/www/html/admin-tdo-V3-ReactRedux/src/components/Main/FoodList/LaCarne.js", "JavaScript", 0, 0, 86, 0, 0, 0, 4, 90
"/var/www/html/admin-tdo-V3-ReactRedux/src/components/Main/FoodList/Pasta.js", "JavaScript", 0, 0, 86, 0, 0, 0, 4, 90
"/var/www/html/admin-tdo-V3-ReactRedux/src/components/Main/FoodList/Pizze.js", "JavaScript", 0, 0, 101, 0, 0, 0, 4, 105
"/var/www/html/admin-tdo-V3-ReactRedux/src/components/Main/FoodList/Tagliate.js", "JavaScript", 0, 0, 87, 0, 0, 0, 3, 90
"/var/www/html/admin-tdo-V3-ReactRedux/src/components/Main/FoodList/Vins.js", "JavaScript", 0, 0, 116, 0, 0, 0, 4, 120
"/var/www/html/admin-tdo-V3-ReactRedux/src/components/Main/Main.js", "JavaScript", 0, 0, 47, 0, 0, 0, 3, 50
"/var/www/html/admin-tdo-V3-ReactRedux/src/components/PostTypeSelector/PostTypeSelector.js", "JavaScript", 0, 0, 73, 0, 0, 0, 4, 77
"/var/www/html/admin-tdo-V3-ReactRedux/src/components/Title/Title.js", "JavaScript", 0, 0, 18, 0, 0, 0, 4, 22
"/var/www/html/admin-tdo-V3-ReactRedux/src/components/Title/title.scss", "SCSS", 3, 0, 0, 0, 0, 0, 1, 4
"/var/www/html/admin-tdo-V3-ReactRedux/src/datas/categories.js", "JavaScript", 0, 0, 35, 0, 0, 0, 2, 37
"/var/www/html/admin-tdo-V3-ReactRedux/src/datas/messages.js", "JavaScript", 0, 0, 16, 0, 0, 0, 3, 19
"/var/www/html/admin-tdo-V3-ReactRedux/src/datas/posttypes.js", "JavaScript", 0, 0, 42, 0, 0, 1, 2, 45
"/var/www/html/admin-tdo-V3-ReactRedux/src/index.js", "JavaScript", 0, 0, 16, 0, 0, 4, 3, 23
"/var/www/html/admin-tdo-V3-ReactRedux/src/store/reducer.js", "JavaScript", 0, 0, 287, 0, 0, 2, 14, 303
"/var/www/html/admin-tdo-V3-ReactRedux/src/store/store.js", "JavaScript", 0, 0, 21, 0, 0, 0, 4, 25
"/var/www/html/admin-tdo-V3-ReactRedux/src/styles/_reset.css", "CSS", 0, 147, 0, 0, 0, 3, 10, 160
"/var/www/html/admin-tdo-V3-ReactRedux/src/styles/_vars.scss", "SCSS", 0, 0, 0, 0, 0, 0, 1, 1
"/var/www/html/admin-tdo-V3-ReactRedux/src/styles/index.scss", "SCSS", 5, 0, 0, 0, 0, 11, 3, 19
"/var/www/html/admin-tdo-V3-ReactRedux/src/utils/utils.js", "JavaScript", 0, 0, 30, 0, 0, 5, 5, 40
"Total", "-", 20, 155, 2985, 12, 7, 64, 285, 3528